=== Maharashtrian ===
Puran Poli|Maharashtrian|Chana dal, Jaggery, Wheat flour|Cook dal, mix with jaggery, roll in dough, cook on tava|5|Sweet traditional recipe|60|Medium|High calories|Festive
Vada Pav|Maharashtrian|Potatoes, Bun, Spices|Boil potatoes, mash, fry patties, serve in bun|4|Street food favorite|30|Easy|Medium calories|Snack
Poha|Maharashtrian|Flattened rice, Onion, Mustard seeds|Soak poha, temper with spices, cook with onion|4|Quick breakfast|15|Easy|Low calories|Breakfast
Misal Pav|Maharashtrian|Sprouts, Onion, Pav, Spices|Cook sprouts curry, serve with pav|5|Spicy and tasty|45|Medium|High protein|Lunch
Bhakri|Maharashtrian|Jowar flour, Water|Mix flour and water, roll and cook on tava|3|Staple flatbread|20|Easy|Low calories|Staple

=== Punjabi ===
Chole|Punjabi|Chickpeas, Onion, Tomato, Spices|Cook chickpeas with gravy|5|Spicy curry|50|Medium|High protein|Lunch
Paneer Butter Masala|Punjabi|Paneer, Butter, Tomato, Cream|Cook paneer in buttery tomato gravy|5|Rich and creamy|40|Medium|High calories|Dinner
Aloo Paratha|Punjabi|Wheat flour, Potato, Spices|Stuff potato in dough, roll and cook|4|Breakfast favorite|30|Easy|Medium calories|Breakfast
Sarson da Saag|Punjabi|Mustard greens, Spices|Cook greens, temper and serve|5|Traditional winter dish|60|Medium|Low calories|Lunch
Lassi|Punjabi|Yogurt, Sugar, Cardamom|Blend yogurt with sugar and cardamom|4|Refreshing drink|10|Easy|Low calories|Beverage

=== South Indian ===
Dosa|South Indian|Rice, Urad dal, Salt|Ferment batter, cook on tava|5|Crispy breakfast|25|Medium|Low calories|Breakfast
Idli|South Indian|Rice, Urad dal, Salt|Steam fermented batter|5|Soft and healthy|20|Easy|Low calories|Breakfast
Sambar|South Indian|Lentils, Tamarind, Vegetables|Cook lentils and veggies in tamarind gravy|5|Spicy soup|35|Medium|High protein|Lunch
Vada|South Indian|Urad dal, Spices|Make batter, fry doughnut-shaped vadas|4|Crunchy snack|20|Easy|Medium calories|Snack
Rasam|South Indian|Tamarind, Tomato, Spices|Boil tamarind and tomato with spices|4|Tangy soup|15|Easy|Low calories|Soup

=== North Indian ===
Rajma|North Indian|Kidney beans, Onion, Tomato, Spices|Cook kidney beans with onion-tomato gravy|5|Comfort food|50|Medium|High protein|Lunch
Dal Makhani|North Indian|Black lentils, Butter, Cream|Cook lentils slowly with butter|5|Rich and creamy|60|Medium|High calories|Dinner
Paratha|North Indian|Wheat flour, Ghee|Roll dough and cook with ghee|4|Staple breakfast|20|Easy|Medium calories|Breakfast
Aloo Gobi|North Indian|Potatoes, Cauliflower, Spices|Cook veggies with spices|4|Vegetarian main dish|35|Easy|Low calories|Lunch
Kheer|North Indian|Rice, Milk, Sugar|Cook rice in milk with sugar and cardamom|5|Dessert|45|Easy|High calories|Dessert

=== Chinese ===
Fried Rice|Chinese|Rice, Vegetables, Soy sauce|Stir fry rice with vegetables and sauce|5|Quick meal|20|Easy|Medium calories|Lunch
Manchurian|Chinese|Vegetables, Flour, Soy sauce|Fry veggie balls, cook in sauce|4|Spicy appetizer|30|Medium|High calories|Snack
Spring Roll|Chinese|Vegetables, Wrapper, Sauce|Roll veggies in wrapper and fry|4|Starter|25|Medium|Medium calories|Snack
Hot and Sour Soup|Chinese|Vegetables, Tofu, Spices|Cook soup with spices|5|Tangy soup|15|Easy|Low calories|Soup
Kung Pao Chicken|Chinese|Chicken, Peanuts, Chili|Stir fry chicken with peanuts and chili|5|Spicy main dish|30|Medium|High protein|Dinner

=== Italian ===
Pasta|Italian|Pasta, Tomato sauce, Cheese|Boil pasta, add sauce and cheese|5|Quick dinner|20|Easy|Medium calories|Dinner
Pizza|Italian|Flour, Cheese, Tomato sauce|Prepare dough, add toppings, bake|5|Favorite snack|30|Medium|High calories|Snack
Lasagna|Italian|Pasta sheets, Cheese, Tomato sauce|Layer pasta and bake with cheese|4|Hearty meal|60|Medium|High calories|Dinner
Risotto|Italian|Rice, Cheese, Vegetables|Cook rice slowly with stock|4|Creamy main dish|40|Medium|Medium calories|Lunch
Tiramisu|Italian|Mascarpone, Coffee, Cocoa|Layer ingredients and chill|5|Dessert|30|Easy|High calories|Dessert

